Microsoft DiskPart, версия 10.0.19041.964

(C) Корпорация Майкрософт (Microsoft Corporation).
На компьютере: DESKTOP-SJS3KGG

DISKPART> help

Microsoft DiskPart, версия 10.0.19041.964

ACTIVE      - Пометка выбранного раздела как активного.
ADD         - Добавление зеркала к простому тому.
ASSIGN      - Назначение имени или точки подключения выбранному тому.
ATTRIBUTES  - Работа с атрибутами тома или диска.
ATTACH      - Присоединяет файл виртуального диска.
AUTOMOUNT   - Включение и отключение автоматического подключения базовых томов.
BREAK       - Разбиение зеркального набора.
CLEAN       - Очистка сведений о конфигурации или всех данных на диске.
COMPACT     - Попытка уменьшения физического размера файла.
CONVERT     - Преобразование форматов диска.
CREATE      - Создание тома, раздела или виртуального диска.
DELETE      - Удалить объект.
DETAIL      - Просмотр параметров объекта.
DETACH      - Отсоединяет файл виртуального диска.
EXIT        - Завершение работы DiskPart.
EXTEND      - Расширить том.
EXPAND      - Увеличение максимального доступного пространства на виртуальном диске.
FILESYSTEMS - Отображение текущей и поддерживаемой файловых систем для тома.
FORMAT      - Форматирование данного тома или раздела.
GPT         - Назначение атрибутов выбранному GPT-разделу.
HELP        - Отображение списка команд.
IMPORT      - Импорт группы дисков.
INACTIVE    - Пометка выбранного раздела как неактивного.
LIST        - Отображение списка объектов.
MERGE       - Объединение дочернего диска с родительскими.
ONLINE      - Перевод объекта, помеченного как "вне сети", в состояние "в сети".
OFFLINE     - Перевод объекта, помеченного как "в сети", в состояние "вне сети" .
RECOVER     - Обновление состояния всех дисков выбранного пакета.
              Попытка восстановить диски неправильного пакета и
              повторная синхронизация зеркальных томов и томов RAID5 с
              устаревшим плексом или данными четности.
REM         - Не выполняет никаких действий. Используется для комментирования сценариев.
REMOVE      - Удаление имени диска или точки подключения.
REPAIR      - Восстановление тома RAID-5 с отказавшим участником.
RESCAN      - Поиск дисков и томов на компьютере.
RETAIN      - Размещение служебного раздела на простом томе.
SAN         - Отображение или установка политики SAN для текущей загруженной ОС.
SELECT      - Установка фокуса на объект.
SETID       - Изменение типа раздела.
SHRINK      - Уменьшение размера выбранного тома.
UNIQUEID    - Отображение или установка кода таблицы разделов GUID (GPT) или
              подписи основной загрузочной записи (MBR) диска.

DISKPART>